jfg: jgs vvx xfv htz dmh zhl
mbg: rqf cbn
plj: bzn bkc dvv bqg mhx
phx: pbh fgr trs
bck: xpr cjn zfl gzz kll
vvm: rdt jqh kkf qzj hrk
cct: rcx cnf tbf
rsz: kcx zhj
fck: zfk
rhh: dsx rtq
gsv: sqr fxv nkj mbj fjv
xsz: tnd rzk rmh zhl
gck: mmd gtk lkb dlm nbt
xtb: fhm pvf
jtr: vms gtp tmp fbz
gvp: hss jtq
qld: fds hqf lzr jxm drc
fzr: jnf tzt
chm: jhq mjp hkj lgj tnv
bgq: knt jhs tjd
tsb: lgd qmx bmt
dxq: hpc lgl phc pst
bqf: xcj
mxs: hbr zcj
bvj: mgk
xkj: smc
zzv: dsg gvp ksz
vtg: skq knz xdt khv vbt
rcx: gbt
jts: xzj mms
dsg: zcq
sfq: jkp jtx dvk
cgs: lgj mjs fcp fbm
cmj: gpf lft mqc kkv
frg: tnd ftj lrq fds
kzq: bmk jkd
hnr: rxv vmv bgz rgt
svf: jcc dxg nlm fzr
txt: ktj vff qgp pzx
fgr: dmg hfc gtp mbj qkx
hzl: zls dsz zkm
hfz: fkk zxj qph
xvx: cjh cqh kzx zrb
jxp: jzx tzx chq qgq
lxx: nnq vng
kvd: fhc ddt sxl
jbg: nsm gql
vgl: spg
xhq: rff kct vdt
zfb: qvh xjs
ptn: szk rpl pmh nrl jcd tcg
lbc: lcr qfd mlp pfd
clv: sfb
ffl: crg bks fzz
bch: hfp qgq jsv qrk
gtp: srb
cjx: svb fbk zsv nxm qxl
pqb: bsd jkm mqq spg
fdz: cmf nsb kzx bfb
clp: lzr lrq std qhl ccp
hkj: hgs
nff: pfd nvf ntj ghd
lhp: tsn dxg lrq
dxb: rqc kkd rbv
dpn: djg hcz rbj cvt
bcp: jcb
grd: ldl rtb
nlc: kng mhj qlp dkd
mlv: fck xzf
vxg: ggd bxb
tgm: tzb
xtj: qnl ckx hzs xsv
nhs: szv zhj
sjf: rcv qbt
ftf: gtl mlv fqr
tzg: qzt cmf vzd crn
glp: dmh qmk
bhx: bsc hpj nhk pzt
jxc: fsm dhf hrb
kdc: fhm fdh cln mkq
dzg: phf
npp: ffb mtr kkv dpn
lvx: mvk gtl bcb
brb: ffn hch fcp
rqk: kph hbp rzz
xbt: hsh
jpv: xkp slh vdv
hzr: fgl dtg kzq xxp
kjq: mbl phf gkv xxn
hpp: vfb dpk fqp
ddt: kkp tmg ksc
gcj: gxq jqv mtx
zsv: rfg
hnc: xtt dmd gpf jvp clq
csf: hbr prh xhh
jrm: jkp fnc xcj
mqq: hfg
lzx: mrs zmg jjx nlp
smq: jbg fpg lmm gdh
ccj: lsd pgv khj
ljq: ngd nxt ftv djk mxs
cnv: szq vhh jgk cnb
gcz: vtj qdv smm brb svb
gsn: stt vgl txf qqb
fpg: sxl
svr: qzc nvg vlf
bzq: bzg xvj rcd
pnm: clk dnp
bpp: fpl xpr
hzs: cvr zfk
lzr: kqr rmv klb mnv
nxf: ptc xrl smv nvq
hvh: fhp
nxx: cjr tvf fjd bbv gtm
clq: dxl rsz
tpx: ckc xrl hpl xnq
dpr: xrn vfk zxj
lmd: lpx xzs rdd hnv
xgk: qmt bjs xxn zgd mml
qrt: ssv mnh
jhx: zkm fhp
bzb: vfg qgp
hsh: kvh
jpt: mzd lfl knl dcs
nnh: dzn gqm khs kgk lpd csc cpl
qtj: svl dtx crr
zmq: hzx
fmv: xrp
ppl: nvq btt trl
vrf: nfb xcg zss knt mhh
fbh: jlx qrk zvz
jcd: zmh ncf kng snd rxv bvh
vbg: jmn
sqr: zhc qvh vrm
lpd: lff pzb bkc
znp: qrt qss kgk dkz
dsx: xcv sfj
xqc: lff lgl pzx nkj
qts: snd xqm
mqc: qjh tzx
cgr: ftl
sdl: qmx hxv dvh cpg zxm
bmk: hnk
zcd: lff rtq
vvl: dnn
bpc: cgl hfd rtz
mlq: zfk sxm xgq
xqq: rvp ddj ncf
dmd: hrb
ltm: zdv zcj kzx xpb
xxn: xgf mcx xsk lkb
sts: lbt
cxp: cjd zlc
jtq: fct
pzt: qhs jlx
vxk: skz gbc
qnq: txt tnd clv
mdh: rbj vmv
kbq: qmk fvp nlx sls
lcm: fsr ggc nxc rzz
svk: fqp
rzc: mft rcj kkh
cmf: dlm jjv
smv: rgt prh
pfh: kxf svm sgk
cbq: dnb gfn ztj fdt
bts: fjh kdl cmf
pmq: lhr bnr xgh brb
zpl: mtx jvp ghr nxt
szv: gtm
zmd: fbz rqf ddh
rzz: mbj lcr hxb
bqd: sqn rmv
qxq: zxq tzh mnh sbq
cfm: bfg
spn: crs kzq qms cnq
gbk: qzp
pzb: fct lbt
khs: tbj thg
ljk: fnd jgk
sch: rbf tqx fbv fbk
krd: bvq
zmh: tsz hpx jbl
tch: hrb xnt qns vsj
kvt: smv vxx hnb zpj
gbc: csz
csc: rsf
dxz: vtj ddm xbz tzh
ftg: tmg jgs
hnx: vkb svj
chj: sxm bxb bjs bdr
hgj: tkv
rqg: tjq rmh trp dnl ctf
sjh: fhs fnc
qsc: jrv hsf kps zds
xhb: vgt hsf rpp xlt
zkh: rtz
fcf: pqd
kcx: tjd
jvt: kcb llg zvk tpj
kfh: zqk grq
xjs: clv
qzz: tdp mjn
xhd: mhx pfd fbv
chg: fqc grz
qpp: jmh hsf jdt ggd
lmg: xmx kkp lhv pxb
lrm: jcb
nvq: hpq mqv
cmb: rmv slz
dbv: zkl hgj mrt
dvh: pqd
nkj: xvr
hmm: xvr
gnr: qrj pxk ntt bfx
vgn: kkm sjl dkc
pbh: dvv cmb
jzz: mbj
fgl: mzc nbk zkh
czc: xmv fdh xgq gdd
mhb: cdg
fkk: lsd rcv
djk: fqp pdz
tvt: dxg hnp ddh vrm
dvb: tbf nqk
ktf: svr ntn fdh ldl
dgj: trp nsn fbf qmx xtr
lht: mhf thb
mlk: mgl sjl fmg sfb
qmb: xjb gsl jhq sls
thz: csz zvz dfj
mgp: cqh mmd thp
pxp: fbf dgf xnk zgz fmh bcv
ldb: mgk tzt
pbf: jhs
fjv: sjh
fxl: hqf pzx cck rdt
vxs: szv hvh qgg dpk
jkm: xjt fds
rkc: vmp btt kcx kjd sqx
zxg: mxs xnq vcv vnd
mrd: tkt spg trp qfd
nvg: qgd pdz qbb
ltb: kjr zfl dvn
bdh: nrz klk qqb kxk jcc gvd
bqp: pml qjg pnh mms dbv
qns: hvj
ggc: rcp
lsq: jbl
qct: rqs rzk tdk lrq prj
tjq: std kjk
zqv: xkr vvp
scq: zhz clk
ddj: scq xlt
dcr: smc lbh mrq
rsg: pzn mzf xbf gtb
cdj: zcj xrl hgj
gxq: szk rjs qnt kcr
vpj: dsc nxm gzz bkc stz srn
qdp: hgm crn
nrz: gbj lnn xlf jfd
zvg: clk
bgx: pjf phx mhp lhk qkx
xgf: rcj fsm vfk
bxt: mhb jnv rgl knk
pkk: cdb lhv rbf
nxg: vhh klt bgz xbt
xrp: sfj sgn
hpc: cjd zzz ztd
nlx: sfq sfv jkd
kxf: fds cbn tbk
mkx: bdr tzb
zdk: vxg trn xlt tkc kps
bnr: ssv
fpv: dlm jbj zvg
sgs: dzg fqr mdv zhj
fsk: vdt rzm
pfc: kzv blz ptd
pml: qgd fsm
kjk: lkr sbb zqk vvl
slh: mkq zrf xzs
dsj: zlh npm qts cfm
kkv: gtm
zlg: vnf mkq gbl
dlr: lzl jdj jfg
zmm: ldl xqq dfm kgd
zhv: ftg
brz: vck szk xhh nzv
vmh: bzb mkl
hfg: hmm lgs pkf
rgh: zrf phl nqm zcl
lzg: svj jkd
dtx: sfj qxl
mhh: sss
gtc: tct
dfq: rhj
hvt: stj zgk kvh vxz
lqm: xpb mbh knz
kgk: pfd znt rqs
kjh: fct hfd xcv pkd
hdm: zjv kzj mkq xgk
qsj: clz vlr
nqm: tkc trl
cpl: fxv mxr rcg
qtt: dzz
hcz: qnl khj pcx tqg
pmp: qtj shp pxd vvp srn
tqx: clb
kzn: cln tkv jfx zjj
gpx: rcp brn chg mjp hxv vsk bpc bks
zpr: rcd qrj rqs
rzk: fqc
kth: grq
rrn: lqt smp lnh vbx
kft: kzv vrm mtv
dgx: xhq xzf
bvp: ccs plv qrs jdt
npc: vfd czq
mfm: xlf nsm
ngk: dpk lpx zcj
lsf: sgn tmg sgx
qjq: qdv rvd mvs nxc
qpn: ndp zlg
vhm: nxj npc kph hld
xlg: hfp vpv psf
tmp: ddz
rpl: nqc sml
ftj: rqd rtz
zbh: zlz xlt nhk
fbf: rcp
ktj: vgl cgr
vfn: glp ddp ksc
trf: dfm mhq fnp mkc dkd
srl: gvs gbt cnq pzb
xgq: thk qdp lht htb
tbf: fhq
ctf: fzr
vzd: tct hzs xll rbj
hnv: jcs hvj nxf
pst: kgk qzj rjt
fxt: kts mrs
slx: zcq fvq nlm
ttz: dqr fnp gmz xlg
qfz: fbf bqg cnq gpb
sbk: jhf tbq dlc
zjk: ffh njf zpr zxq
zds: zkm qns
djq: rqs
lfz: cng hpr tbg nqc
fzv: nxc bvj pgs ptd
pgh: fcp tbj bfx rtn
kxk: qrv gvx tmc
zss: khj hbr
nsb: hpp zxj
mjs: kth
jvp: hvj pnm
vng: sml
kps: nvk jvm
fjd: qjg ftf nrv
skz: hpq zxj
nhl: bsc dcr nbt jjc
xzs: rxv nqg
qbt: xsv
szs: dxl tjd
xnd: mnh pbh mjn bzg
tkc: lqt gtk xrn fxj
qgg: smp snt
ttd: fhc mgl tdp ffl qnc
ggd: dml
gzl: fnc hmm cmp hnp
jqh: sgk fnc sgx
rtd: xsk xqt hrb
cnb: qjg fnp
skh: xdh tbh csz
fjg: fsr xvr
tbj: tmc
jnz: vkb
npm: mdv bkm
kxm: tsn vkb dhx
vfz: jgv cdb klq ffn
psn: pbf ljq
vsv: fhs sqn zhv xjt kth
nvp: vlr lrm mvt hnb
qgd: xpb
pgj: vfg nvf xph
csr: kjc hgs gbk rzk
bpk: hbf lhm fmg
mcn: xbr fsk xzj vzd mtr
hnp: zlc
cnt: csc spc vfn xhv gpb
gfn: vlt nqr
qrr: tmr
tsc: qqv jrm dpj
smm: bqd pxk
phb: tnv jkd fbk
fhq: fsr xjt
jbv: dmd xzj
bxb: hpq
nlm: vgl
rtp: hfm dkp
nmx: rcp xlq pjf xvj
rgm: dqg hqj tpc vvt sfx
tvb: ztd bnb dxb ftl zpf
lgs: svx xjs btg
jgb: mkx xhh
xkk: gdv vfp mlj vnd
htb: vng nzx zxt
kjr: hnx mgk
ghd: qpz jls
ssz: pgn bcp rtb zmh
tzn: mqv psf
pmn: rvx qtn llg vbg
rhz: bzg mck qnq tkt
brp: jbl nhs zhz
lft: hpq stj
lpz: xtr lhm mxr spc
pxn: jtq
rqh: dkr sbq
kzv: fhs
rgc: tbk kbl tng vrm gpm
gvn: jmr mhj ckx htq
kkd: zmq qpz
fdt: vdm tzb
tnz: zzz tsc qxl
bjj: cbq ccj fcx dpr kng
rgt: zjv
nhk: cng gbc
kdl: lbz jgk
nlr: vrl hgj jxp xrn kct
jjx: tzb lzn
qnc: kph mbs
nxc: xkr
kzj: xhh tdt xgf
kfv: qxq mhm phc rjt fmg
bcv: kxm fnc kjc qpz
gsc: dhf knt hnb
qbd: kzz gcq mbh rcj
qqz: djg zdv gmz jzc rbj
dkz: dkc
zlh: fcx zmg mnt
vgb: lqk qsl znt txf bsd
psb: pqd dmh
prl: ctg mgp dpk fsm
xsn: fmq slz jzn
kzt: jzx dfm prk gtl
nxj: hnm
fpm: dzz ccp qxl jdj trk
lkl: hvh dnp
lmm: xtr fzz
zqx: cxx vfg ztd ggl
drc: sbb tzh
tkt: ctf xcj qrj ddm
dns: mck pgs
mlj: mlq jjx xhp vrh
mcx: xtb lrc
bkz: kfh kll nhf fvq
cln: tjv xdt
cpg: glz
lxq: dkd qgd mhj
tng: xrp kgh zfb
ggl: tbj blz
hvj: fsm
hjp: ddz
vlf: rhp
mjn: kll
kng: zjv
dcs: zdn thk
trs: fks
gzz: ddh cbn
rmh: cxp fpl fks
lgl: vgl
xbr: dmd cvr vrr
stt: jtq sfv mfm
dhx: mnh
src: rhj ctg xtj rtb
lch: vcv cqh mks xgz
hsb: bfb cst
rln: qsj prh
mtr: zdn jvm
rfh: ngd rtp csf vpv nlp
jnf: vcp fnc
rrm: vvl tqx tbf grq
dsc: dkj cct kfh
bgv: tjz knl khj snt
rmj: fbz shp kzv kkp
zvv: tzx jgb dnb
mzf: xll
dfj: qdp jdt
srs: mkl
jmx: qpn zbh knl vfp vhk dgx
vcv: hbr
gxj: bzg srs jgs crr
std: czq lkc jnz
khv: dqr bjs qnl
qbb: bkm zgk gdd
mvk: trm pdz qrr
cnq: lnn
mrx: skz
sxm: dnp
qhl: qkx pzx kkf zhl hmm qzz hkj
bgz: bsc
hpj: mbn bfb
mrt: grd rjs jhf
ths: zqv mjp fhn
mbs: tnd blz
lkb: jgb pvf dsz cdg
mrq: pgv
lcr: zpf ssv ltl
htq: vlg
mks: zhj dvr
kkm: dvv jtx
xdh: lmx zls
vrm: sts
dzz: srs
dvn: gzc
tdv: mrx pvg gtc bkm
zxm: txc gql rbv
shp: rtz
cjr: mrx xlt mrk
zck: tnv cjq
rsl: mft hnb dgn dhf cnb
qcx: fdz gpf bvh dvr
xtt: rdd tmr
mxp: sxz hnp zgz
jbn: gqc trl xdh stm gvb fhp
jfx: scr vhd vdm
djg: kkv
zkl: cmj lbh zvk
lnn: grq zjn zsv
tbq: dfq zvg dzm
nrl: zdv gtc csz
nqk: qqv
rhr: vmp cng
knc: bdr cvr dkp zjj tgm
rdt: mxf cjd xbz hkj bmk bzq
mgb: lkf lsq hpj
nrj: shd psf cmj gtl
dxn: mdr mlv cnb bfb
trk: xtr ntt xgh
psf: vhd
cjq: jtx
bsd: gkq qgp
cqh: jdt
hmd: xmn lbt hmm
tph: zmq ljt fhc chg
gdd: nnq
vsc: kts dml
pqq: ffn kkd
zzm: dkp scr kcx
rqc: qsl ddp
mrc: vbx cst
bgn: hnb rjs pbf
msn: zlh lsq lrc
brf: dpj jzn vvj nsm
xsj: szv gpf mqv ntn
bnb: lrl
mtx: rvp
hjx: hfd zzv ssv
dtg: rjt fpl sxn hch
lxj: qbt xsv mrq
nqg: xmv
vrr: mhq rsz
zls: hpr
mzr: gvs ctf vfg fjv btd
sfx: krd crg
qfd: ckf lls lzg
kgh: zsv zgz pgs
crq: fjv zmq cnf gql
qsl: rsv nvf
sdq: rtq zbt pkk
jps: kzv vvp zlc
zfl: nxj ksc
pkv: jtx dtx
xbl: mbn rcj snd
ltc: bvq mvj
rxb: tfb
dzt: srb rfg vzf
lgz: phc lzr jkp mjs lgd
hbp: dxg tsb
sxn: scc bvj qss
zgz: vvx
shg: vhm dgf fsr fct
tmv: fbz pkd pxk hff
xmt: pfc fmq hld vhj
vmp: mhj
fxj: pdz
vhj: fmh sxl
nzv: zxg gmz jcb
xqt: mhh nvk cdg
vgt: ftv hfp lzn
kjf: hjp drt rqj rgc rtq
rkd: fxt jts
plv: gkj ztv
bsl: bqs jzx mlq mnt kct
kcb: vnd jnv
snh: jpv htq xnt
tvf: zmh mtr pmh
plt: hjp fbz mgb rqk svj
xgz: ztr
mml: zxt lkl bxp zmm
svm: mvj vvt pxn
hrk: dsx mvs
hvp: bqs mkc
pvf: smc
zmb: vvt ffn bmk
hpl: kct fpv snh tjv jbv
fxr: kll ppb hjp
ngd: mbn cvt
dnn: zbn
qdv: bvq
glv: hbs kkg dfc
brn: qvh
bfx: fhq trs
ztd: jhq
vbx: ncf lzn
tkv: zpj
hff: xfv tdp hfd
hnk: lbt
ltl: bvq cbn
xcz: cst jcx
pgn: vdf
vrt: mzf csf msn zhj
qqq: lhm lhv
hxb: rdm kmv svm cjq
pgr: xmv qhs nrj bsx
xll: snt
zxq: mvj
rpp: vfb mcx kgd
fxv: ggc mnv
xrl: vdm dxl
xmx: bpk gbk qqv
ckh: qts vhk pgn jhx
kjg: dqg xsd pqb
stz: bnb rqj bgb sts
shd: hsb nzx vnf
tql: trn nvk cfm
gvb: nfb
lkf: rpl jcb thb
hld: fbk sbb
txc: dln rsv
qhj: mmx szq
fcp: mxf
lhr: cxx tbj sbq fhs
gfs: vcp dzz
jpl: rzm mkq fgj mrc
rgf: fcn jcx brz cfm jjr
dvr: btt
jfz: hch ghd htz zzv rcg
hkt: jfd gzl fbk pgs
lbv: qnt
xsh: vxx gvb vsj lrc
jzx: lbz
mjp: xcj
jrc: srs pxb
rqf: cmp
gmf: rsf bzn hss fhc
crb: nlm mjn dvb
hbf: jbg
kcp: gpf lxx vcl hzl hvp
vdv: fqr mmx vcv trm
tdt: zzm gkj
bzg: cjd
ljr: qtj sfb fxv ndj
zrb: xrl kcr
jpk: pmn xzz jvm pgr
jjn: kpt ffh rhh xbz
zfc: vfd mgt ddp nvf
zsj: qnc bzg
pcx: tqg tmr
bmb: mvj bnb lsf
nbk: fhn zmb gtt zhv
dvv: srs xtr
rvp: szs lbh
nfs: xxp xbz mgl
nds: ffn cdb fbj
lmx: lpx lfl mrs
kgm: nsm gfj
zkk: tzx
mfx: jmn vjm jhs xcz
ckk: rzm zdn kkg
lls: xkr
phf: jgk vlg
tcs: hrk vfg svx
fqf: pdz fhm ghr vrl ftf
pkx: mlq psn lbh hjv
pzj: jkz qqv dln zcq tnz
gsl: xlq gbt
gpm: mkt dqg lff
dlc: mbl zhj zll
sls: pqd
jmp: vsk bpp clv ddz sjh
rng: mhx jkp bqd tjq
cmm: rln gcj zgd svk jhx
lbt: vfg
sjr: xjs dnn xhd dvb
rdd: vnf qzc
jcr: sfv lcp nds sfx
hpt: vxz cng zvv
sqx: xsk vrd lld
chd: cvs mms crn
vxz: mrc bgz
chq: zjv tbh
szk: bjs
lrl: dln
bqt: hjg lqm ckk rxb hsf
kmv: cpg xkr
fjh: trl pml hfm snt
rts: vjv mfm jzz bzb
kvh: vjm
jnv: jdt pkn
zcf: vbg tbg pvg bgn qsj
frh: fkh zjj zkk
gxr: hjg bcp ztj vdm vlt
pdv: zbt brn fmq njr
qgs: tdt pvf gkv mrq
svb: hnk tbk
rnm: bnr tbj pkv blb
qms: sfn jzz
xpr: bks lkc
ztv: zlz
bxs: thg njr snq tcs cpg
lbl: lsd lrm tbh nsb pbf
dnl: bks
lnh: fpk xcz qbb vnf
tkz: svr knl skh cvs
hnz: hss fxk bqf
snq: xsd mqq jls
qgp: fhq
vjv: ddz thg rfg
kjm: smm xjb pxk slz
qtc: jgv fpg sfn ndg
sfj: qqq
dkc: fmh
gkq: znt mxp
hqf: qtt qrt qxl
rff: qnt knt
dzd: zmq lls
vjd: vfg kmj dhx zsj
hbs: knt zvz xpb
kjl: mtr vgt jfx xrl
htp: pdz szs
hss: mnv
ghn: cxx dmm mbg
vfd: sjl sbb
lcp: ggl sfv
fdd: vsj htp
dtk: zbx zpf qmk sls
jfd: clb dbt
stj: lmv
mtv: phc kmv bnr
sxl: gbk nkj
qkl: nvq zvz lzn rkd
clb: qmx
qrk: jzx xhq zxt
vbt: dqr hsb
jjr: zgd fdd vxg nxt
cmp: xfv
dch: klk dtk nvf dfl
lld: zgk fdd dfq
sgk: hch
fkh: kdl fxt rhr
vtj: fcp
zhc: crs vcp rvd dkz
ztj: qzc
bpv: rvp knz vbg cqx vlf vxk
tbg: hgm rgt
qxf: pmh jqv mtr
cdb: qqq zxq gbt tmc
shf: rtn lff xck zjr
dgn: xxn pvg xkj nzx
rhj: ghr tct
gqc: jdt
clh: mqq kjg lkr csc
pkd: lrl jkp
qdz: qnd kzj frh llg
zpk: gdd mks qpn zlz tzn xgf npm
gdh: lzg sgk xnk
ncp: kbl mnk psb zqv klb rdm
gsd: lmm spn tzh zck
plx: srb gkq fjg cct
gtb: nqr zhz rhp pkn
mvt: bqs ckx xsk
rbv: gzc
xcv: xgh
qzt: xzj bxp dvr
clz: xtb jcs scf
pxd: kgm zfb
ffh: zfl fvp
bfv: jrc dfl tmg
dlm: mrs
gtl: pzt
gvd: vvp dbt
thp: jbj bfg
dbt: tjd
zbl: hvh kvh qjg cqh
pkn: ghr
zll: jvp xnq
qph: pgv rhr scq fbh
scf: lbp jxc
htz: grq ccp
kpt: fqc jls
cjh: xzs hgm
mdv: tbh vlr cvs
ccs: hgm jzc qtg
xph: gbj gvd hgs
lsn: sjl sbz rqk ktj
jhp: srs sdq bqg mhx kvn trs dnl jck
mgt: jkm lbt ldb
lqk: jdj pzx xlq
mck: tzh
trp: rqd
xnz: kcb fxj scf xlt
jxd: xgr kkh rln mrx lbp dhf
fvq: tbf ksz srn
smp: tjd xlt
nnq: gcq
qgq: fhm
xcs: rxb xbl bjr bgv
zsh: qtt cxx tmp sjh
lnc: dfq qrq xkj
hpr: lht vfb
hjv: htj mhq
vmv: pdz
dqg: dkc
tsz: jsv qgq
hsf: gtm
jdj: rsf
vfp: tjz
vlt: mbn
jcs: kcr
fns: rvx nqg rgl
klk: svx clv
mdr: gcq fdt dlm
ssp: bnr htz rqc
thk: zjv mhf
dgv: jzn dgj thg dmg lcm zcd xvj lgl
bcb: cvf mhq vsc cdj
ppb: xsg blz
qlv: zxt dfc ljk
fhk: lrl qss kph dtg dkj
lzp: pxn krd svj nsn
sml: dzm hsh
kvx: rmv rbf hnm ztd
dnp: vjm
dkr: sxz ssv
tnd: xjb mlp
sfn: tmp mkl
bdg: fsk hfm qnd vlf
jcc: bpk
gmk: jmn rkd qrq glv
dkd: kzx
qtr: zvg zpj hjg
bqq: ltb vff rqd ltl
xlf: htz kkf
bjr: vxx qns qmt pmn
dmm: czt xcv lcp
nkn: pll xtt jjv
nzz: fmv sqn hbf crg
rcd: qqq rbf
gkv: qrr
xkp: knk gvn mqv trm
lbx: mbj dkz zlc
hqj: xvr czt hzx
xqm: csz kvh lrc
pvg: ldl
trn: clk jjv knl kkh
vhd: nxt
tbv: lfl psn npx vlg
sbz: cpg rng dzd
ffb: qtr dfj mrk
snd: gbc
ckx: scr
ckc: djk krs tjv
thn: fxk pkv chg xxp
lvf: zkh vnv xph
kgs: fmv njr lgj lvf
szl: zss crn ddj fnp
zmg: vfb ljk fcx
fzz: lgj
fbv: sfq ddp
pnh: cvs dcs tkv
chh: rtd rzm rvx bsc
vrx: zkk jpv mmd pmn
kqr: djq
lbp: gbl xll
xnk: fcf
dlp: kkp qtt ftg cpg
kmj: qvh cmb
mft: vhd gmz
xnt: mhh dnb hsh
ndg: pxk mck bkc
ncb: dvb gfj dnl sqn khs
rgv: tjv tzn bvh ppl
skq: smc
kbl: ntt zqk
hnf: qxq qrj gfs hqf
cqx: prh xbt ddj
bdr: jsv
hpx: zdn bfb xgz
ksz: czq xsg
xsd: vkb ftg
qrq: vmp
blb: fbm gfs dkz mbg gtp zcq
tcg: jmr clq thb
hbn: vmp dfc fdh
mxr: svj
njr: fmg jrc dns
jbl: gmz pcx
lhk: dzt hfs zck rqd
dgf: crs rqh
gkj: rcv
bsx: svk xnq qgg djk gdd
tjz: tqg szs
gbj: jnz
kjd: dfm thb mnt
tzp: qhl qmk rqj npc dvh
xtm: ctf sxz hnk cgr nsm dsg
lpx: lrm tqg jcs
snl: vvp vvt mkl qzp
btd: ppb qrv bfv
zbn: rsf nxj
btk: kth srb dln sgn
jbj: lkl kcr
mnk: rcg zkh gfj
qrv: vkb
nsn: gvp crg fpl
bfb: xlg
xck: fmv rvd lhm
dsz: dfc
txf: phb cck
knk: vnf jjv
zvk: lpx
xbf: gcq jsv
jmh: stj rcj
dfl: tmc jkp
bfg: dml
lrq: gzc
ksc: tnd
gdv: vgr vfk ctg lxj
hdk: lkb lmv tfb mqc
svl: gtp zfc
vrd: zjj jzc
prk: xgz pgv qbt
bqg: vsk
mpf: dbv tsz xzz pll
cgl: jxm ndm kjc
mbl: ztv
hcg: bcp hvp zlz
ghp: pmt ttd vff rsv
qmt: mdh skq
bkm: lmv
jng: lvx hbn vhd cmm
cpf: snl jps gsl std
vjx: fks rbv vvx sdl
qjh: xhh
ndm: vvl mrl trp
rtn: ddm zmd
scc: djq zmq vtj ltc
ndp: qtr thp gtc
mkc: gvb nzx mzf
klt: phf vdt xdt
xhp: cdg vdf nfb vlt
tzb: snd
xmn: sfb lkc
ljg: fzr cxp ltb nzz vff
lph: lgd bqf rng psb
fks: shp
tdp: zck
cnf: ltc pzx
rdm: lgd jzz
kzz: fkk vtg hpt qtg tgm cvf
jcn: mhm txc csr
lxh: lbx dnl kvz xmn
mxx: qdv cck kjc fxk
pzn: dxl tgm
cjn: kkf tsb xsn
gcm: mbs bmt cts fpl jcn
ljt: gqm
qkx: vfg
kgd: htj cvt gkv ztv
hfc: sts xvj vmh
srn: rsf jmp
smk: dhx qtt bgb xgh
stm: ndp tfb tch dgx
sgl: qtn lxq sbk ztr
cvf: chd bjs
nbc: nds slx fzz shg
vck: xqt vnd kts
pmt: mgk drj tzt qxj
rmv: gqm
lqt: dzg xkj
xmh: trm rff xbt gsc
tvh: clp znt hld fhn ths
qss: zlc
htj: tjd vfk
vrh: lbv qnd rxv mrk nhs
vsj: jgb vrl pll rsz pgn vxx
jkz: kjr fxk qjq bqf
gpb: ggc fcf jgs
mrl: drc pqd
zjn: fbj qpz
sph: fxt pzn grd fqr
ctg: fnd qhs
rqj: zck
qrs: jhx htj zls rjs
mlp: vcp
vxx: zgk mqv
bzn: lgd fjg
lsd: fcx
cts: qmk crs tnd
mmx: dsz
mzd: dmd vrd gkv dlc nvk
lkr: fds
kts: nfb
brl: mzf qgd lft jbv
gvs: dsg lhm
rrr: vpj mjn hnm vgn
jrn: lbh rbj gfn nld
mbh: lbz jjv qjh
vms: fcf
pjf: ntj kjc spc
njf: ddh zqk ftj rqf
mhp: sgn nqk kpt
jjc: dzg qrs vng
ndj: hzx hnm zjn bpp
gbs: kqr btd lkr sbq
vhk: tmr zkk
kxl: hjv tfb jqv scq
hxl: mhm ghn drt kvz
ldj: lhp sgx qgp kvd
czq: gqm xfv
npx: xrn vrl
nhf: fqc
rgl: hfp vxk
klq: nfs fpl xrp zsj
dzm: zrb ztj ztr
ldv: qhs htq fcx rtb
tzt: xvj znt
rjt: mnv vvx rmv svl dvn btg ddm
fgj: kjd thz bfg
njz: qrq qzc jrv jqv
drt: rfg qqq
zlp: lhr zbn qqb lmm
vhh: rhp gfn qtr
btg: jxm hgs
ntj: nsm gzc
xxf: qzp hbp fvp xnk
kvz: zzz gpb
ftl: zbt
jcx: mbn vmv
hnb: vjm
mrs: chd dnb fck
jrv: gmz
ptd: vvp
gds: knz brp sjf pmh zll
xcg: xbf nxt qhj
jlx: xdt crn
vdf: zxj
mxf: svj
bgb: xsg kqr
zcl: rzc nlr lft
vnv: ljt mlp sgx
vzf: pfd mhm phb bmb
nbt: xzf jrv
ntn: btt ngk npn jhf tql skq
xzz: bsc vsc cjh
vcl: rcj djg bdr
rmr: rhp bjs rvp nxg
mnp: zhz bvh fnd gtc nqr
qvh: xpr
jls: pkf bmk
jgn: zvk qjh rcv pll knl hnr
gtt: hgs dvh vff
bbv: hnb vlf bgq
zzz: rcg
mnt: nnq
zrf: chq zkm gkj
szq: vfp bgq nvk vxx
kkg: mhb mbl
njs: fbj fhn slz gbj
czt: vms hmm grz kgm
mgl: spc
tdk: cmp dpj zcd
xdv: vsk lls rbf mjs
vvj: fmh ptd ldb
znd: crq kgh mrl mvs
dnd: xdv dvk svx nhf
drj: mgk pxd dvv
xgr: hfz hfm lnc hvh
fbm: blz zhl
npn: nkn fsm qnd
xhv: rqh ftl hkt
gql: psb
nct: nqk xjt pkf bgb
jck: kzv rbv rsv
nld: jzc cst vbt
fqp: qnd
trm: pkn jts
dcg: mvs sbb xlq dvk kmj
pvn: czq dbt jhq kkm
rsf: tnv
vpd: lzp fhn jcc pfh
mmd: htp jmn ncf
tpc: xxp zpr nrz qrv
lzl: tbk vms
qxn: vdt zkm dkp clk
vgr: clz lfl
ztr: hfm
qtg: lmv
qtn: fpk lmx mdv
bqs: qxf mrt
kvn: jzz mxf klb
vtk: qrr fkk pnm smv
klb: xjb dkc
ssf: pxb rvd hff pqq gsd
cxx: hnz cjq
sbc: vpv jqv xnt lbv
cck: qzp ddm zbt
lpp: fmq zbn mkt hbf
llg: hvp
bmr: gbl vgr lld vpv
nqr: tct
mrk: zpj
gtk: mdh mhq
bzk: xll qlv plv rtp
cng: vjm
gbl: vlg
zbx: dkr spg mgl
krs: htp rxb npx dkp
zbf: ntt lhv pqq zmb
gvx: kmv svx glp zpf qzz
jxm: qns qdv
fcn: vrr xsv pml
qzj: pgj trk pxn
mkt: qms nxm ljt mxx
mhf: lmv lrc
hfs: bvj vmh cgr clb dzd
zjr: fpg nmx nhf dlr
vlr: ftv
spg: grz sxz
qhs: xmv
nrv: svk bxb dml rgl
qqb: hqf
lfx: fnd zvz ptc rcv
bmt: blz
mcq: zds dkp hfm nxt
hzx: lkc
bcl: rcx zhv rbf fxr
rmd: lxx sxm mmx zdv
nlp: qbt tct
jhs: csz
jgv: zpf mlp
fpk: ggd qnl hjg nqg
nhd: bcz fsk qtg fxj kcr crn
zxt: fhp
fpz: bmt dvk hjx bcl
glz: dmg krd xsg
hzv: gqc qnt vdf qhj
bjb: jzn kjg brn crg dvn
jjf: mkx jmr zgd
nqc: zlz jhf
tkp: hmd kft pxb rhh
qlp: stj gtb xrl
hxv: lzl kpt
dzn: blz dkz mzc
dkj: tsn sgk
qsz: dnn pkf krd gsl
cvr: lbz
bxp: lsq jmh
bcz: qgq cvt jmr
ckf: fpg jnz dpj
pgv: vnf
dqr: btt ftv
prj: gql dmh gbk
xzf: tmr
dmg: ddz
kvq: glv sjf kzj hcg scr kkh bts gbl mms jvm
fvp: fbj crb
ptc: mhb tct
mzc: dns tqx cgl jnf
tpj: pkn xgf mtx
lfd: ssp grz pqd rtz
tjn: hnx tcs kjr rcx
jmr: gqc
sss: zfk rvx hgj lbv
phl: fns jjf tfb
ccp: rtz
prr: nqm rrn fck zjv
qxj: qqq tsn sjl
ppt: djq mxr nxm gfj
crr: vhj shp
